111111111111111
101000101110001
300010001110001
101011101100001
101011100000101
111011101010101
100001001011101
101101011010002
101100010000001
111111111111111